Initial Map
     00  01  02  03  04  05  06  07  08  09 
 00 [S1] ~~  ~~  ~~  ~~  ~~  ~~  ~~  ~~ [A1]
 01  ~~  ~~  ~~  ~~  ~~  ~~  ~~  ~~  ~~  ~~ 
 02  ~~  ~~  ~~  ~~  ~~  ~~  ~~  ~~  ~~  ~~ 
 03  ~~  ~~  ~~  ~~  ~~  ~~  ~~  ~~  ~~  ~~ 
 04  ~~  ~~  ~~  ~~  ~~  ~~  ~~  ~~  ~~  ~~ 
 05  ~~  ~~  ~~  ~~  ~~  ~~  ~~  ~~  ~~  ~~ 
 06  ~~  ~~  ~~  ~~  ~~  ~~  ~~  ~~  ~~  ~~ 
 07  ~~  ~~  ~~  ~~  ~~  ~~  ~~  ~~  ~~  ~~ 
 08  ~~  ~~  ~~  ~~  ~~  ~~  ~~  ~~  ~~  ~~ 
 09 [C1] ~~  ~~  ~~  ~~  ~~  ~~  ~~  ~~ [T1]

After T = 0
     00  01  02  03  04  05  06  07  08  09 
 00  ~~  ~~  ~~  ~~  ~~  ~~  ~~  ~~ [A1] ~~ 
 01 [S1] ~~  ~~  ~~  ~~  ~~  ~~  ~~  ~~  ~~ 
 02  ~~  ~~  ~~  ~~  ~~  ~~  ~~  ~~  ~~  ~~ 
 03  ~~  ~~  ~~  ~~  ~~  ~~  ~~  ~~  ~~  ~~ 
 04  ~~  ~~  ~~  ~~  ~~  ~~  ~~  ~~  ~~  ~~ 
 05  ~~  ~~  ~~  ~~  ~~  ~~  ~~  ~~  ~~  ~~ 
 06  ~~  ~~  ~~  ~~  ~~  ~~  ~~  ~~  ~~  ~~ 
 07  ~~  ~~  ~~  ~~  ~~  ~~  ~~  ~~  ~~  ~~ 
 08 [C1] ~~  ~~  ~~  ~~  ~~  ~~  ~~  ~~ [T1]
 09  ~~  ~~  ~~  ~~  ~~  ~~  ~~  ~~  ~~  ~~ 

After T = 1
     00  01  02  03  04  05  06  07  08  09 
 00  ~~  ~~  ~~  ~~  ~~  ~~  ~~ [A1] ~~  ~~ 
 01  ~~  ~~  ~~  ~~  ~~  ~~  ~~  ~~  ~~  ~~ 
 02 [S1] ~~  ~~  ~~  ~~  ~~  ~~  ~~  ~~  ~~ 
 03  ~~  ~~  ~~  ~~  ~~  ~~  ~~  ~~  ~~  ~~ 
 04  ~~  ~~  ~~  ~~  ~~  ~~  ~~  ~~  ~~  ~~ 
 05  ~~  ~~  ~~  ~~  ~~  ~~  ~~  ~~  ~~  ~~ 
 06  ~~  ~~  ~~  ~~  ~~  ~~  ~~  ~~  ~~  ~~ 
 07 [C1] ~~  ~~  ~~  ~~  ~~  ~~  ~~  ~~ [T1]
 08  ~~  ~~  ~~  ~~  ~~  ~~  ~~  ~~  ~~  ~~ 
 09  ~~  ~~  ~~  ~~  ~~  ~~  ~~  ~~  ~~  ~~ 

After T = 2
     00  01  02  03  04  05  06  07  08  09 
 00  ~~  ~~  ~~  ~~  ~~  ~~ [A1] ~~  ~~  ~~ 
 01  ~~  ~~  ~~  ~~  ~~  ~~  ~~  ~~  ~~  ~~ 
 02  ~~  ~~  ~~  ~~  ~~  ~~  ~~  ~~  ~~  ~~ 
 03 [S1] ~~  ~~  ~~  ~~  ~~  ~~  ~~  ~~  ~~ 
 04  ~~  ~~  ~~  ~~  ~~  ~~  ~~  ~~  ~~  ~~ 
 05  ~~  ~~  ~~  ~~  ~~  ~~  ~~  ~~  ~~  ~~ 
 06 [C1] ~~  ~~  ~~  ~~  ~~  ~~  ~~  ~~ [T1]
 07  ~~  ~~  ~~  ~~  ~~  ~~  ~~  ~~  ~~  ~~ 
 08  ~~  ~~  ~~  ~~  ~~  ~~  ~~  ~~  ~~  ~~ 
 09  ~~  ~~  ~~  ~~  ~~  ~~  ~~  ~~  ~~  ~~ 

After T = 3
     00  01  02  03  04  05  06  07  08  09 
 00  ~~  ~~  ~~  ~~  ~~ [A1] ~~  ~~  ~~  ~~ 
 01  ~~  ~~  ~~  ~~  ~~  ~~  ~~  ~~  ~~  ~~ 
 02  ~~  ~~  ~~  ~~  ~~  ~~  ~~  ~~  ~~  ~~ 
 03  ~~  ~~  ~~  ~~  ~~  ~~  ~~  ~~  ~~  ~~ 
 04  ~~  ~~  ~~  ~~  ~~  ~~  ~~  ~~  ~~  ~~ 
 05 [C1] ~~  ~~  ~~  ~~  ~~  ~~  ~~  ~~ [T1]
 06  ~~  ~~  ~~  ~~  ~~  ~~  ~~  ~~  ~~  ~~ 
 07  ~~  ~~  ~~  ~~  ~~  ~~  ~~  ~~  ~~  ~~ 
 08  ~~  ~~  ~~  ~~  ~~  ~~  ~~  ~~  ~~  ~~ 
 09  ~~  ~~  ~~  ~~  ~~  ~~  ~~  ~~  ~~  ~~ 

After T = 4
     00  01  02  03  04  05  06  07  08  09 
 00  ~~  ~~  ~~  ~~ [A1] ~~  ~~  ~~  ~~  ~~ 
 01  ~~  ~~  ~~  ~~  ~~  ~~  ~~  ~~  ~~  ~~ 
 02  ~~  ~~  ~~  ~~  ~~  ~~  ~~  ~~  ~~  ~~ 
 03  ~~  ~~  ~~  ~~  ~~  ~~  ~~  ~~  ~~  ~~ 
 04 [C1] ~~  ~~  ~~  ~~  ~~  ~~  ~~  ~~ [T1]
 05  ~~  ~~  ~~  ~~  ~~  ~~  ~~  ~~  ~~  ~~ 
 06  ~~  ~~  ~~  ~~  ~~  ~~  ~~  ~~  ~~  ~~ 
 07  ~~  ~~  ~~  ~~  ~~  ~~  ~~  ~~  ~~  ~~ 
 08  ~~  ~~  ~~  ~~  ~~  ~~  ~~  ~~  ~~  ~~ 
 09  ~~  ~~  ~~  ~~  ~~  ~~  ~~  ~~  ~~  ~~ 

After T = 5
     00  01  02  03  04  05  06  07  08  09 
 00  ~~  ~~  ~~ [A1] ~~  ~~  ~~  ~~  ~~  ~~ 
 01  ~~  ~~  ~~  ~~  ~~  ~~  ~~  ~~  ~~  ~~ 
 02  ~~  ~~  ~~  ~~  ~~  ~~  ~~  ~~  ~~  ~~ 
 03 [C1] ~~  ~~  ~~  ~~  ~~  ~~  ~~  ~~ [T1]
 04  ~~  ~~  ~~  ~~  ~~  ~~  ~~  ~~  ~~  ~~ 
 05  ~~  ~~  ~~  ~~  ~~  ~~  ~~  ~~  ~~  ~~ 
 06  ~~  ~~  ~~  ~~  ~~  ~~  ~~  ~~  ~~  ~~ 
 07  ~~  ~~  ~~  ~~  ~~  ~~  ~~  ~~  ~~  ~~ 
 08  ~~  ~~  ~~  ~~  ~~  ~~  ~~  ~~  ~~  ~~ 
 09  ~~  ~~  ~~  ~~  ~~  ~~  ~~  ~~  ~~  ~~ 

After T = 6
     00  01  02  03  04  05  06  07  08  09 
 00  ~~  ~~ [A1] ~~  ~~  ~~  ~~  ~~  ~~  ~~ 
 01  ~~  ~~  ~~  ~~  ~~  ~~  ~~  ~~  ~~  ~~ 
 02 [C1] ~~  ~~  ~~  ~~  ~~  ~~  ~~  ~~ [T1]
 03  ~~  ~~  ~~  ~~  ~~  ~~  ~~  ~~  ~~  ~~ 
 04  ~~  ~~  ~~  ~~  ~~  ~~  ~~  ~~  ~~  ~~ 
 05  ~~  ~~  ~~  ~~  ~~  ~~  ~~  ~~  ~~  ~~ 
 06  ~~  ~~  ~~  ~~  ~~  ~~  ~~  ~~  ~~  ~~ 
 07  ~~  ~~  ~~  ~~  ~~  ~~  ~~  ~~  ~~  ~~ 
 08  ~~  ~~  ~~  ~~  ~~  ~~  ~~  ~~  ~~  ~~ 
 09  ~~  ~~  ~~  ~~  ~~  ~~  ~~  ~~  ~~  ~~ 

After T = 7
     00  01  02  03  04  05  06  07  08  09 
 00  ~~ [A1] ~~  ~~  ~~  ~~  ~~  ~~  ~~  ~~ 
 01  ~~  ~~  ~~  ~~  ~~  ~~  ~~  ~~  ~~ [T1]
 02  ~~  ~~  ~~  ~~  ~~  ~~  ~~  ~~  ~~  ~~ 
 03  ~~  ~~  ~~  ~~  ~~  ~~  ~~  ~~  ~~  ~~ 
 04  ~~  ~~  ~~  ~~  ~~  ~~  ~~  ~~  ~~  ~~ 
 05  ~~  ~~  ~~  ~~  ~~  ~~  ~~  ~~  ~~  ~~ 
 06  ~~  ~~  ~~  ~~  ~~  ~~  ~~  ~~  ~~  ~~ 
 07  ~~  ~~  ~~  ~~  ~~  ~~  ~~  ~~  ~~  ~~ 
 08  ~~  ~~  ~~  ~~  ~~  ~~  ~~  ~~  ~~  ~~ 
 09  ~~  ~~  ~~  ~~  ~~  ~~  ~~  ~~  ~~  ~~ 

